file	word
NWS	pornography/weighted
access	pornography/weighted
acp	weapons/weighted
action	pornography/weighted;weapons/weighted
adult	personals/weighted;pornography/weighted
adults	pornography/weighted
ak	weapons/weighted
alkyl	illegaldrugs/weighted
als	pornography/weighted
altsex	pornography/weighted
ammo	weapons/weighted
amyl	illegaldrugs/weighted
anal	pornography/weighted
angel	pornography/weighted
animal	pornography/weighted
anime	pornography/weighted
ar	weapons/weighted
armory	weapons/weighted
arse	pornography/weighted
asia	pornography/weighted
asian	pornography/weighted
ass	pornography/weighted
avs	pornography/weighted
babe	pornography/weighted
babes	pornography/weighted
bald	pornography/weighted
ball	pornography/weighted
balls	pornography/weighted
bandit	pornography/weighted
bang	pornography/weighted
banks	pornography/weighted
banned	pornography/weighted
barely	pornography/weighted
bbw	pornography/weighted
bbws	pornography/weighted
bdsm	pornography/weighted
beads	pornography/weighted
bear	pornography/weighted
bears	pornography/weighted
beauty	pornography/weighted
beaver	pornography/weighted
beer	legaldrugs/weighted
belt	pornography/weighted;weapons/weighted
beppin	pornography/weighted
betty	pornography/weighted
bi	pornography/weighted
biatch	pornography/weighted
biguns	pornography/weighted
bikini	pornography/weighted
binge	legaldrugs/weighted
bird	pornography/weighted
bitch	pornography/weighted
black	pornography/weighted;weapons/weighted
blonde	pornography/weighted
blow	pornography/weighted
blows	pornography/weighted
bluing	weapons/weighted
boff	pornography/weighted
bolt	weapons/weighted
bomb	weapons/weighted
bone	pornography/weighted
bong	illegaldrugs/weighted
boob	pornography/weighted
boobs	pornography/weighted
booty	pornography/weighted
boy	pornography/weighted
bra	pornography/weighted
bras	pornography/weighted
breast	pornography/weighted
bren	weapons/weighted
brew	legaldrugs/weighted
brown	pornography/weighted
browse	personals/weighted
brutal	pornography/weighted
buffer	weapons/weighted
bugger	pornography/weighted
bullet	weapons/weighted
bung	pornography/weighted
buried	pornography/weighted
buster	pornography/weighted
busty	pornography/weighted
butt	pornography/weighted
butyl	illegaldrugs/weighted
call	pornography/weighted
cam	pornography/weighted
camel	pornography/weighted
camera	pornography/weighted
carpet	pornography/weighted
casual	pornography/weighted
celeb	pornography/weighted
celebs	pornography/weighted
cervix	pornography/weighted
chat	pornography/weighted
check	pornography/weighted
cheeks	pornography/weighted
cheer	pornography/weighted
cherry	pornography/weighted
chick	pornography/weighted
child	pornography/weighted
chloe	pornography/weighted
chrome	pornography/weighted
chubby	pornography/weighted
chunky	pornography/weighted
churd	pornography/weighted
cigars	legaldrugs/weighted
circle	pornography/weighted
circus	pornography/weighted
city	pornography/weighted
clam	pornography/weighted
clamp	pornography/weighted
climax	pornography/weighted
clip	illegaldrugs/weighted
clit	pornography/weighted
clits	pornography/weighted
clitty	pornography/weighted
club	pornography/weighted
coated	pornography/weighted
cock	pornography/weighted
cocks	pornography/weighted
coital	pornography/weighted
coitus	pornography/weighted
color	pornography/weighted
comic	pornography/weighted
comix	pornography/weighted
compl	pornography/weighted
core	pornography/weighted
couple	pornography/weighted
cover	pornography/weighted
crack	illegaldrugs/banned;illegaldrugs/weighted
crazy	pornography/weighted
cream	pornography/weighted
creamy	pornography/weighted
cruise	weapons/weighted
cuffs	pornography/weighted
cum	pornography/weighted
cums	pornography/weighted
cunt	pornography/weighted
cuntal	pornography/weighted
cunts	pornography/weighted
cupid	personals/weighted
cute	pornography/weighted
cyber	pornography/weighted
daddy	pornography/weighted
daily	pornography/weighted
dating	personals/weighted
deemed	pornography/weighted
deep	pornography/weighted
deeper	pornography/weighted
desire	pornography/weighted
dezire	pornography/weighted
dialer	pornography/weighted
diaper	pornography/weighted
dick	pornography/weighted
dicks	pornography/weighted
dildo	pornography/weighted
dildos	pornography/weighted
dirty	pornography/weighted
dive	pornography/weighted
diving	pornography/weighted
doctor	pornography/weighted
dog	pornography/weighted
doggie	pornography/weighted
doggy	pornography/weighted
dogs	pornography/weighted
doll	pornography/weighted
dong	pornography/weighted
doodle	pornography/weighted
dorada	pornography/weighted
dorm	pornography/weighted
double	pornography/weighted
dr	pornography/weighted
drench	pornography/weighted
drink	pornography/weighted
drinks	legaldrugs/weighted
drip	pornography/weighted
drunk	pornography/weighted
dvd	pornography/weighted
dwarf	pornography/weighted
dyke	pornography/weighted
eater	pornography/weighted
eating	pornography/weighted
ebony	pornography/weighted
elder	pornography/weighted
email	pornography/weighted
enema	pornography/weighted
enjoy	pornography/weighted
enough	pornography/weighted
enter	pornography/weighted
erotic	pornography/weighted
escort	pornography/weighted
eunuch	pornography/weighted
events	pornography/weighted
ezine	pornography/weighted
face	pornography/weighted
faces	pornography/weighted
facial	pornography/weighted
fantas	pornography/weighted
fat	pornography/weighted
fatal	pornography/weighted
feast	pornography/weighted
fed	weapons/weighted
fem	pornography/weighted
female	pornography/weighted
femdom	pornography/weighted
femme	pornography/weighted
fest	pornography/weighted
fetish	pornography/weighted
fhm	pornography/weighted
fill	pornography/weighted
filled	pornography/weighted
filthy	pornography/weighted
finder	personals/weighted
fine	pornography/weighted
finest	pornography/weighted
finger	pornography/weighted
firing	weapons/weighted
fist	pornography/weighted
fisted	pornography/weighted
flab	pornography/weighted
flaps	pornography/weighted
flesh	pornography/weighted
flics	pornography/weighted
flix	pornography/weighted
fog	pornography/weighted
food	pornography/weighted
forced	pornography/weighted
frenum	pornography/weighted
frenzy	pornography/weighted
friend	personals/weighted;pornography/weighted
fuck	pornography/weighted
fucked	pornography/weighted
fucker	pornography/weighted
fucks	pornography/weighted
gag	pornography/weighted
galler	pornography/weighted
gamma	illegaldrugs/weighted
gang	pornography/weighted
ganga	illegaldrugs/weighted
ganja	illegaldrugs/weighted
gargle	pornography/weighted
garter	pornography/weighted
gay	personals/weighted;pornography/weighted
gays	pornography/weighted
geek	pornography/weighted
gets	pornography/weighted
ghb	illegaldrugs/weighted
giant	pornography/weighted
girl	pornography/weighted
girls	pornography/weighted
giving	pornography/weighted
glock	weapons/weighted
goblet	pornography/weighted
golden	pornography/weighted
gooey	pornography/weighted
grab	pornography/weighted
granny	pornography/weighted
gratis	pornography/weighted
great	pornography/weighted
greek	pornography/weighted
group	pornography/weighted
gspot	pornography/weighted
guide	personals/weighted;pornography/weighted
gun	weapons/weighted
guns	weapons/weighted
gyno	pornography/weighted
hairy	pornography/weighted
hand	pornography/weighted
handle	personals/weighted
hanf	illegaldrugs/weighted
hanky	pornography/weighted
hard	pornography/weighted
hardon	pornography/weighted
hasch	illegaldrugs/weighted
haven	pornography/weighted
head	pornography/weighted
heaven	pornography/weighted
heavy	pornography/weighted
hentai	pornography/weighted
heroin	illegaldrugs/weighted
herpes	pornography/weighted
hidden	pornography/weighted
hik	nudism/weighted
hoe	pornography/weighted
hole	pornography/weighted
holy	nudism/weighted
honeys	pornography/weighted
hooker	pornography/weighted
hornee	pornography/weighted
horney	pornography/weighted
horny	pornography/weighted
horse	pornography/weighted
hot	pornography/weighted
hotel	pornography/weighted
hotsex	pornography/weighted
hottie	pornography/weighted
huge	pornography/weighted
humper	pornography/weighted
hungry	pornography/weighted
hunt	pornography/weighted
hymen	pornography/weighted
image	pornography/weighted
images	pornography/weighted
incest	pornography/weighted
indian	pornography/weighted
inner	pornography/weighted
insane	pornography/weighted
inside	pornography/weighted
jack	pornography/weighted
jello	legaldrugs/weighted
jelly	pornography/weighted
jenna	pornography/weighted
jerk	pornography/weighted
jism	pornography/weighted
jizm	pornography/weighted
jizz	pornography/weighted
job	pornography/weighted
jones	pornography/weighted
juggs	pornography/weighted
jugs	pornography/weighted
juice	pornography/weighted
juicy	pornography/weighted
junky	pornography/weighted
just	pornography/weighted
kahr	weapons/weighted
kama	pornography/weighted
kara's	pornography/weighted
karups	pornography/weighted
keg	legaldrugs/weighted
kegs	legaldrugs/weighted
kiddie	pornography/weighted
killed	violence/weighted
killer	violence/weighted
kinky	pornography/weighted
knife	weapons/weighted
knives	weapons/weighted
kock	weapons/weighted
kokain	illegaldrugs/weighted
koks	illegaldrugs/weighted
labia	pornography/weighted
lactat	pornography/weighted
ladies	pornography/weighted
lady	pornography/weighted
latex	pornography/weighted
latina	pornography/weighted
latino	pornography/weighted
leak	pornography/weighted
legal	pornography/weighted
lesbo	pornography/weighted
lewd	pornography/weighted
lezbo	pornography/weighted
lick	pornography/weighted
licked	pornography/weighted
lickin	pornography/weighted
lips	pornography/weighted
liquor	legaldrugs/weighted
little	pornography/weighted
lluvia	pornography/weighted
load	pornography/weighted
login	pornography/weighted
lolita	pornography/weighted
lounge	pornography/weighted
love	pornography/weighted
lover	pornography/weighted
lovers	pornography/weighted
lovin	pornography/weighted
loving	pornography/weighted
lsd	illegaldrugs/weighted
lube	pornography/weighted
lust	pornography/weighted
mac	weapons/weighted
mag	pornography/weighted;weapons/weighted
magna	pornography/weighted
making	weapons/weighted
male	pornography/weighted
malt	legaldrugs/weighted
man	pornography/weighted
maniac	pornography/weighted
manual	pornography/weighted
master	pornography/weighted
mature	pornography/weighted
mauser	weapons/weighted
maxim	pornography/weighted
meat	pornography/weighted
mega	pornography/weighted
melons	pornography/weighted
member	pornography/weighted
men	personals/weighted;pornography/weighted
messy	pornography/weighted
meth	illegaldrugs/weighted
mff	pornography/weighted
micro	legaldrugs/weighted
midget	pornography/weighted
milf	pornography/weighted
mixed	legaldrugs/weighted
mmf	pornography/weighted
model	pornography/weighted
models	pornography/weighted
moist	pornography/weighted
most	pornography/weighted
movie	pornography/weighted
mpeg	pornography/weighted
muff	pornography/weighted
munch	pornography/weighted
murder	violence/weighted
mutual	pornography/weighted
myself	pornography/weighted
nailed	pornography/weighted
naked	pornography/weighted
nasty	pornography/weighted
nature	nudism/weighted;pornography/weighted
necked	pornography/weighted
needs	pornography/weighted
nekkid	nudism/weighted
new	pornography/weighted
newd	pornography/weighted
newds	pornography/weighted
newdz	pornography/weighted
nip	pornography/weighted
nipple	pornography/weighted
nra	weapons/weighted
nsfw	pornography/weighted
nubile	pornography/weighted
nude	nudism/weighted;pornography/weighted
nudes	pornography/weighted
nudie	pornography/weighted
nudism	nudism/weighted
nudist	nudism/weighted
nudity	nudism/weighted;pornography/weighted
nurse	pornography/weighted
nut	pornography/weighted
nympho	pornography/weighted
old	pornography/weighted
older	pornography/weighted
online	personals/weighted;pornography/weighted
only	pornography/weighted
ooze	pornography/weighted
open	pornography/weighted
opiate	illegaldrugs/weighted
opium	illegaldrugs/weighted
oppio	illegaldrugs/weighted
oral	pornography/weighted
orgasm	pornography/weighted
orgazm	pornography/weighted
orgies	pornography/weighted
orgy	pornography/weighted
pages	pornography/weighted
panky	pornography/weighted
panty	pornography/weighted
party	pornography/weighted
pass	pornography/weighted
patrol	pornography/weighted
pearl	pornography/weighted
pearly	pornography/weighted
pee	pornography/weighted
peeing	pornography/weighted
peesex	pornography/weighted
penile	pornography/weighted
penis	pornography/weighted
petite	pornography/weighted
phone	pornography/weighted
photos	pornography/weighted
phuck	pornography/weighted
pic	pornography/weighted
pics	pornography/weighted
pills	illegaldrugs/weighted
pimp	pornography/weighted
pink	pornography/weighted
pinup	pornography/weighted
pipe	illegaldrugs/weighted;legaldrugs/weighted
pirate	pornography/weighted
piss	pornography/weighted
pistol	weapons/weighted
pix	pornography/weighted
planet	pornography/weighted
play	pornography/weighted
plug	pornography/weighted
plump	pornography/weighted
poker	pornography/weighted
poo	pornography/weighted
poop	pornography/weighted
poosex	pornography/weighted
popper	pornography/weighted
pork	pornography/weighted
porn	pornography/weighted
porno	pornography/weighted
posing	pornography/weighted
powder	weapons/weighted
precum	pornography/weighted
pretty	pornography/weighted
prick	pornography/weighted
prn	pornography/weighted
prno	pornography/weighted
public	pornography/weighted
puffy	pornography/weighted
pump	pornography/weighted
pumped	pornography/weighted
puss	pornography/weighted
pussy	pornography/weighted
putas	pornography/weighted
rack	pornography/weighted
raider	pornography/weighted
ram	pornography/weighted
rammed	pornography/weighted
range	weapons/weighted
rape	pornography/weighted;violence/weighted
raped	pornography/weighted
rapist	pornography/weighted
rated	pornography/weighted
ratedx	pornography/weighted
raw	pornography/weighted
real	pornography/weighted
recoil	weapons/weighted
rectum	pornography/weighted
reefer	illegaldrugs/weighted
report	personals/weighted
rifle	weapons/weighted
rifles	weapons/weighted
rimjob	pornography/weighted
rimmed	pornography/weighted
ripe	pornography/weighted
ripper	pornography/weighted
roach	illegaldrugs/weighted
rob	pornography/weighted
rod	pornography/weighted
root	pornography/weighted
rubber	pornography/weighted
ruger	weapons/weighted
saiga	weapons/weighted
saigon	pornography/weighted
sao	pornography/weighted
scan	pornography/weighted
scat	pornography/weighted
scene	pornography/weighted
school	pornography/weighted
screw	pornography/weighted
search	personals/weighted;pornography/weighted
secret	pornography/weighted
semen	pornography/weighted
semi	weapons/weighted
series	pornography/weighted
server	pornography/weighted
sets	pornography/weighted
sex	pornography/weighted
sexcam	pornography/weighted
sexkey	pornography/weighted
sexo	pornography/weighted
sextoy	pornography/weighted
sexual	pornography/weighted
sexxx	pornography/weighted
sexy	pornography/weighted
shaved	pornography/weighted
shaven	pornography/weighted
sheer	pornography/weighted
shit	pornography/weighted
shlong	pornography/weighted
shoot	pornography/weighted
shoots	pornography/weighted
shop	pornography/weighted
shot	pornography/weighted
shots	pornography/weighted
shower	pornography/weighted
sick	pornography/weighted
sin	pornography/weighted
sinful	pornography/weighted
skanky	pornography/weighted
skimpy	pornography/weighted
slave	pornography/weighted
slit	pornography/weighted
sloppy	pornography/weighted
slurp	pornography/weighted
slut	pornography/weighted
sluts	pornography/weighted
slutty	pornography/weighted
smear	pornography/weighted
smell	pornography/weighted
smelly	pornography/weighted
smith	weapons/weighted
smoker	pornography/weighted
smoo	pornography/weighted
smooth	pornography/weighted
smut	pornography/weighted
snatch	pornography/weighted
sniff	pornography/weighted
sniper	weapons/weighted
snuff	pornography/weighted
soak	pornography/weighted
soaked	pornography/weighted
sodomy	pornography/weighted
soft	pornography/weighted
soggy	pornography/weighted
sore	pornography/weighted
spank	pornography/weighted
spears	pornography/weighted
sperm	pornography/weighted
spill	pornography/weighted
spl	weapons/weighted
spot	pornography/weighted
spray	pornography/weighted
spread	pornography/weighted
spunk	pornography/weighted
spurt	pornography/weighted
spy	pornography/weighted
squirt	pornography/weighted
stain	pornography/weighted
stand	pornography/weighted
steit	violence/weighted
steyr	weapons/weighted
sticky	pornography/weighted
stiff	pornography/weighted
stiffy	pornography/weighted
still	legaldrugs/weighted
stoned	illegaldrugs/weighted
strap	pornography/weighted
strip	pornography/weighted
strips	pornography/weighted
stud	pornography/weighted
studio	pornography/weighted
sub	weapons/weighted
suck	pornography/weighted
sucker	pornography/weighted
sutra	pornography/weighted
sweet	pornography/weighted
sweety	pornography/weighted
sword	weapons/weighted
swords	weapons/weighted
taboo	pornography/weighted
tacho	pornography/weighted
takes	pornography/weighted
tasty	pornography/weighted
tease	pornography/weighted
tec	weapons/weighted
teen	pornography/weighted
teens	pornography/weighted
ten	weapons/weighted
their	pornography/weighted
thick	pornography/weighted
thigh	pornography/weighted
thong	pornography/weighted
throat	pornography/weighted
thru	pornography/weighted
tight	pornography/weighted
tiny	pornography/weighted
tit	pornography/weighted
title	pornography/weighted
tits	pornography/weighted
tittie	pornography/weighted
titty	pornography/weighted
toilet	pornography/weighted
tongue	pornography/weighted
tool	pornography/weighted
toon	pornography/weighted
toons	pornography/weighted
tour	pornography/weighted
toy	pornography/weighted
toys	pornography/weighted
tramps	pornography/weighted
tranny	pornography/weighted
trial	pornography/weighted
triple	pornography/weighted
tryout	pornography/weighted
tshirt	pornography/weighted
turd	pornography/weighted
turned	pornography/weighted
twat	pornography/weighted
uncut	pornography/weighted
under	pornography/weighted
unique	pornography/weighted
unseen	pornography/weighted
usc	pornography/weighted
uzi	weapons/weighted
vagina	pornography/weighted
vainy	pornography/weighted
vibe	pornography/weighted
video	pornography/weighted
virgin	pornography/weighted
visual	nudism/weighted;pornography/weighted
vodka	legaldrugs/weighted
voyeur	pornography/weighted
voyuer	pornography/weighted
vulgar	pornography/weighted
vulva	pornography/weighted
wank	pornography/weighted
wanker	pornography/weighted
wanna	pornography/weighted
warm	pornography/weighted
watch	pornography/weighted
weapon	weapons/weighted
wear	pornography/weighted
webcam	pornography/weighted
weird	pornography/weighted
wesson	weapons/weighted
wet	pornography/weighted
whack	pornography/weighted
white	pornography/weighted
whore	pornography/weighted
whores	pornography/weighted
whre	pornography/weighted
wife	pornography/weighted
wild	pornography/weighted
winery	legaldrugs/weighted
wives	pornography/weighted
woman	pornography/weighted
women	personals/weighted;pornography/weighted
worst	pornography/weighted
x	pornography/weighted
xrated	pornography/weighted
xxx	pornography/weighted
xxxx	pornography/weighted
yeast	pornography/weighted
young	pornography/weighted
